        XX
X XXX XXXX
D XXX   XX
 XXXXXX XX
XXXXXXX XX
DXXXXXX XX
XXXXDXXDXX